1111111111111111111111111111111111
1G00000000000000001111111111111111
1111111111111111101111111111111111
1111111111111111101111111111111111
1111111111111111101111111111111111
1G00000000001111101111111111111111
1111111111101111101111111111111111
1111111111101111101111111111111111
1111111111101111101111111111111111
1G00001111101111101111111111111111
1111101111101111101111111111111111
1111101111101111101111111111111111
1111101111101111101111111111111111
10000PCCCCCCCCCCCCCCCCCCCCCCCCCCE1
1101111101111101111111111111111111
1G01111101111101111111001111111111
1111111101111101111111001111111111
1111111101111101111111001111111111
1111111101111101111111111111111111
1G00000001111101111111111111111111
1111111111111101111111111111111111
1111111111111101111111111111111111
1111111111111101111111111111111111
1111111111111111111111111111111111