11111111111111111111
10C00100G0C0001C0011
1G11C10111111C101E01
101000P0000G00000101
101011C11C011011C101
101011011111101101C1
1C1000000G0000000101
1011010111111C1C1101
1C00010000000010G001
11111111111111111111