11111111111111111111
10C001000C00001C0011
1011C10111111C101E01
10100000000000000101
101011C110011011C101
101011011111101101C1
1C1000000P0000000101
1011010111111C1C1101
1C000100000000100001
11111111111111111111