11111111111111111111
10C001000C0GG01C0011
1G11C10111111C101E01
101000PG000000000101
101011C11C011011C101
101011011111101101C1
1C10000000000000G101
1011010111111C1C1101
1C000100000000100001
11111111111111111111